replyign-	replying-
replyign:	replying:
replyign;	replying;
replyign.	replying.
replyign 	replying 
Replyign 	Replying 
abadoned-	abandoned-
abadoned:	abandoned:
abadoned;	abandoned;
abadoned.	abandoned.
abadoned 	abandoned 
Abadoned 	Abandoned 
ablums-	albums-
ablums:	albums:
ablums;	albums;
ablums.	albums.
ablums 	albums 
Ablums 	Albums 
accomidate-	accommodate-
accomidate:	accommodate:
accomidate;	accommodate;
accomidate.	accommodate.
accomidate 	accommodate 
Accomidate 	Accommodate 
accomidates-	accommodates-
accomidates:	accommodates:
accomidates;	accommodates;
accomidates.	accommodates.
accomidates 	accommodates 
Accomidates 	Accommodates 
accoutning-	accounting-
accoutning:	accounting:
accoutning;	accounting;
accoutning.	accounting.
accoutning 	accounting 
Accoutning 	Accounting 
accuratly-	accurately-
accuratly:	accurately:
accuratly;	accurately;
accuratly.	accurately.
accuratly 	accurately 
Accuratly 	Accurately 
accureate-	accurate-
accureate:	accurate:
accureate;	accurate;
accureate.	accurate.
accureate 	accurate 
Accureate 	Accurate 
actucally-	actually-
actucally:	actually:
actucally;	actually;
actucally.	actually.
actucally 	actually 
Actucally 	Actually 
addign-	adding-
addign:	adding:
addign;	adding;
addign.	adding.
addign 	adding 
Addign 	Adding 
adn-	and-
adn:	and:
adn;	and;
adn.	and.
adn 	and 
Adn 	And 
aggresive-	aggressive-
aggresive:	aggressive:
aggresive;	aggressive;
aggresive.	aggressive.
aggresive 	aggressive 
Aggresive 	Aggressive 
agin-	again-
agin:	again:
agin;	again;
agin.	again.
agin 	again 
Agin 	Again 
agreesive-	aggressive-
agreesive:	aggressive:
agreesive;	aggressive;
agreesive.	aggressive.
agreesive 	aggressive 
Agreesive 	Aggressive 
ahve-	have-
ahve:	have:
ahve;	have;
ahve.	have.
ahve 	have 
Ahve 	Have 
alos-	also-
alos:	also:
alos;	also;
alos.	also.
alos 	also 
Alos 	Also 
alrady-	already-
alrady:	already:
alrady;	already;
alrady.	already.
alrady 	already 
Alrady 	Already 
alwasy-	always-
alwasy:	always:
alwasy;	always;
alwasy.	always.
alwasy 	always 
Alwasy 	Always 
amzaing-	amazing-
amzaing:	amazing:
amzaing;	amazing;
amzaing.	amazing.
amzaing 	amazing 
Amzaing 	Amazing 
anf-	and-
anf:	and:
anf;	and;
anf.	and.
anf 	and 
Anf 	And 
anythign-	anything-
anythign:	anything:
anythign;	anything;
anythign.	anything.
anythign 	anything 
Anythign 	Anything 
applicaiton-	application-
applicaiton:	application:
applicaiton;	application;
applicaiton.	application.
applicaiton 	application 
Applicaiton 	Application 
applicaitons-	applications-
applicaitons:	applications:
applicaitons;	applications;
applicaitons.	applications.
applicaitons 	applications 
Applicaitons 	Applications 
applicatoin-	application-
applicatoin:	application:
applicatoin;	application;
applicatoin.	application.
applicatoin 	application 
Applicatoin 	Application 
applicatoins-	applications-
applicatoins:	applications:
applicatoins;	applications;
applicatoins.	applications.
applicatoins 	applications 
Applicatoins 	Applications 
arealdy-	already-
arealdy:	already:
arealdy;	already;
arealdy.	already.
arealdy 	already 
Arealdy 	Already 
aroudn-	around-
aroudn:	around:
aroudn;	around;
aroudn.	around.
aroudn 	around 
Aroudn 	Around 
aslo-	also-
aslo:	also:
aslo;	also;
aslo.	also.
aslo 	also 
Aslo 	Also 
asnwer-	answer-
asnwer:	answer:
asnwer;	answer;
asnwer.	answer.
asnwer 	answer 
Asnwer 	Answer 
assuption-	assumption-
assuption:	assumption:
assuption;	assumption;
assuption.	assumption.
assuption 	assumption 
Assuption 	Assumption 
avaialble-	available-
avaialble:	available:
avaialble;	available;
avaialble.	available.
avaialble 	available 
Avaialble 	Available 
avalibale-	avaliable-
avalibale:	avaliable:
avalibale;	avaliable;
avalibale.	avaliable.
avalibale 	avaliable 
Avalibale 	Avaliable 
bahavior-	behavior-
bahavior:	behavior:
bahavior;	behavior;
bahavior.	behavior.
bahavior 	behavior 
Bahavior 	Behavior 
becomming-	becoming-
becomming:	becoming:
becomming;	becoming;
becomming.	becoming.
becomming 	becoming 
Becomming 	Becoming 
becuase-	because-
becuase:	because:
becuase;	because;
becuase.	because.
becuase 	because 
Becuase 	Because 
begining-	beginning-
begining:	beginning:
begining;	beginning;
begining.	beginning.
begining 	beginning 
Begining 	Beginning 
betwwen-	between-
betwwen:	between:
betwwen;	between;
betwwen.	between.
betwwen 	between 
Betwwen 	Between 
cacncel-	cancel-
cacncel:	cancel:
cacncel;	cancel;
cacncel.	cancel.
cacncel 	cancel 
Cacncel 	Cancel 
cacnel-	cancel-
cacnel:	cancel:
cacnel;	cancel;
cacnel.	cancel.
cacnel 	cancel 
Cacnel 	Cancel 
cahnge-	change-
cahnge:	change:
cahnge;	change;
cahnge.	change.
cahnge 	change 
Cahnge 	Change 
cahnged-	changed-
cahnged:	changed:
cahnged;	changed;
cahnged.	changed.
cahnged 	changed 
Cahnged 	Changed 
cahnges-	changes-
cahnges:	changes:
cahnges;	changes;
cahnges.	changes.
cahnges 	changes 
Cahnges 	Changes 
caht-	chat-
caht:	chat:
caht;	chat;
caht.	chat.
caht 	chat 
Caht 	Chat 
caluclate-	calculate-
caluclate:	calculate:
caluclate;	calculate;
caluclate.	calculate.
caluclate 	calculate 
Caluclate 	Calculate 
cehck-	check-
cehck:	check:
cehck;	check;
cehck.	check.
cehck 	check 
Cehck 	Check 
cehcks-	checks-
cehcks:	checks:
cehcks;	checks;
cehcks.	checks.
cehcks 	checks 
Cehcks 	Checks 
chagne-	change-
chagne:	change:
chagne;	change;
chagne.	change.
chagne 	change 
Chagne 	Change 
chagnes-	changes-
chagnes:	changes:
chagnes;	changes;
chagnes.	changes.
chagnes 	changes 
Chagnes 	Changes 
challege-	challenge-
challege:	challenge:
challege;	challenge;
challege.	challenge.
challege 	challenge 
Challege 	Challenge 
charater-	character-
charater:	character:
charater;	character;
charater.	character.
charater 	character 
Charater 	Character 
charaters-	characters-
charaters:	characters:
charaters;	characters;
charaters.	characters.
charaters 	characters 
Charaters 	Characters 
charcter-	character-
charcter:	character:
charcter;	character;
charcter.	character.
charcter 	character 
Charcter 	Character 
charcters-	characters-
charcters:	characters:
charcters;	characters;
charcters.	characters.
charcters 	characters 
Charcters 	Characters 
chari-	chair-
chari:	chair:
chari;	chair;
chari.	chair.
chari 	chair 
Chari 	Chair 
charis-	chairs-
charis:	chairs:
charis;	chairs;
charis.	chairs.
charis 	chairs 
Charis 	Chairs 
chnage-	change-
chnage:	change:
chnage;	change;
chnage.	change.
chnage 	change 
Chnage 	Change 
chnages-	changes-
chnages:	changes:
chnages;	changes;
chnages.	changes.
chnages 	changes 
Chnages 	Changes 
collaboratoin-	collaboration-
collaboratoin:	collaboration:
collaboratoin;	collaboration;
collaboratoin.	collaboration.
collaboratoin 	collaboration 
Collaboratoin 	Collaboration 
colums-	columns-
colums:	columns:
colums;	columns;
colums.	columns.
colums 	columns 
Colums 	Columns 
commetn-	comment-
commetn:	comment:
commetn;	comment;
commetn.	comment.
commetn 	comment 
Commetn 	Comment 
commetns-	comments-
commetns:	comments:
commetns;	comments;
commetns.	comments.
commetns 	comments 
Commetns 	Comments 
commitee-	committee-
commitee:	committee:
commitee;	committee;
commitee.	committee.
commitee 	committee 
Commitee 	Committee 
commt-	commit-
commt:	commit:
commt;	commit;
commt.	commit.
commt 	commit 
Commt 	Commit 
completly-	completely-
completly:	completely:
completly;	completely;
completly.	completely.
completly 	completely 
Completly 	Completely 
concensus-	consensus-
concensus:	consensus:
concensus;	consensus;
concensus.	consensus.
concensus 	consensus 
Concensus 	Consensus 
congradulate-	congratulate-
congradulate:	congratulate:
congradulate;	congratulate;
congradulate.	congratulate.
congradulate 	congratulate 
Congradulate 	Congratulate 
consitent-	consistent-
consitent:	consistent:
consitent;	consistent;
consitent.	consistent.
consitent 	consistent 
Consitent 	Consistent 
consoel-	console-
consoel:	console:
consoel;	console;
consoel.	console.
consoel 	console 
Consoel 	Console 
convension-	convention-
convension:	convention:
convension;	convention;
convension.	convention.
convension 	convention 
Convension 	Convention 
convensions-	conventions-
convensions:	conventions:
convensions;	conventions;
convensions.	conventions.
convensions 	conventions 
Convensions 	Conventions 
correctoin-	correction-
correctoin:	correction:
correctoin;	correction;
correctoin.	correction.
correctoin 	correction 
Correctoin 	Correction 
correctoins-	corrections-
correctoins:	corrections:
correctoins;	corrections;
correctoins.	corrections.
correctoins 	corrections 
Correctoins 	Corrections 
coudl-	could-
coudl:	could:
coudl;	could;
coudl.	could.
coudl 	could 
Coudl 	Could 
culteral-	cultural-
culteral:	cultural:
culteral;	cultural;
culteral.	cultural.
culteral 	cultural 
Culteral 	Cultural 
cultueral-	culteral-
cultueral:	culteral:
cultueral;	culteral;
cultueral.	culteral.
cultueral 	culteral 
Cultueral 	Culteral 
dahboard-	dashboard-
dahboard:	dashboard:
dahboard;	dashboard;
dahboard.	dashboard.
dahboard 	dashboard 
Dahboard 	Dashboard 
dahboards-	dashboards-
dahboards:	dashboards:
dahboards;	dashboards;
dahboards.	dashboards.
dahboards 	dashboards 
Dahboards 	Dashboards 
dasboard-	dashboard-
dasboard:	dashboard:
dasboard;	dashboard;
dasboard.	dashboard.
dasboard 	dashboard 
Dasboard 	Dashboard 
dasboards-	dashboards-
dasboards:	dashboards:
dasboards;	dashboards;
dasboards.	dashboards.
dasboards 	dashboards 
Dasboards 	Dashboards 
dashbaord-	dashboard-
dashbaord:	dashboard:
dashbaord;	dashboard;
dashbaord.	dashboard.
dashbaord 	dashboard 
Dashbaord 	Dashboard 
dashbaords-	dashboards-
dashbaords:	dashboards:
dashbaords;	dashboards;
dashbaords.	dashboards.
dashbaords 	dashboards 
Dashbaords 	Dashboards 
deatail-	detail-
deatail:	detail:
deatail;	detail;
deatail.	detail.
deatail 	detail 
Deatail 	Detail 
deatails-	details-
deatails:	details:
deatails;	details;
deatails.	details.
deatails 	details 
Deatails 	Details 
defence-	defense-
defence:	defense:
defence;	defense;
defence.	defense.
defence 	defense 
Defence 	Defense 
defences-	defenses-
defences:	defenses:
defences;	defenses;
defences.	defenses.
defences 	defenses 
Defences 	Defenses 
defualt-	default-
defualt:	default:
defualt;	default;
defualt.	default.
defualt 	default 
Defualt 	Default 
descion-	decision-
descion:	decision:
descion;	decision;
descion.	decision.
descion 	decision 
Descion 	Decision 
descions-	decisions-
descions:	decisions:
descions;	decisions;
descions.	decisions.
descions 	decisions 
Descions 	Decisions 
desgin-	design-
desgin:	design:
desgin;	design;
desgin.	design.
desgin 	design 
Desgin 	Design 
desgins-	designs-
desgins:	designs:
desgins;	designs;
desgins.	designs.
desgins 	designs 
Desgins 	Designs 
desigining-	designing-
desigining:	designing:
desigining;	designing;
desigining.	designing.
desigining 	designing 
Desigining 	Designing 
desribed-	described-
desribed:	described:
desribed;	described;
desribed.	described.
desribed 	described 
Desribed 	Described 
dicide-	decide-
dicide:	decide:
dicide;	decide;
dicide.	decide.
dicide 	decide 
Dicide 	Decide 
dicsuss-	discuss-
dicsuss:	discuss:
dicsuss;	discuss;
dicsuss.	discuss.
dicsuss 	discuss 
Dicsuss 	Discuss 
dicuss-	discuss-
dicuss:	discuss:
dicuss;	discuss;
dicuss.	discuss.
dicuss 	discuss 
Dicuss 	Discuss 
differetn-	different-
differetn:	different:
differetn;	different;
differetn.	different.
differetn 	different 
Differetn 	Different 
differnet-	different-
differnet:	different:
differnet;	different;
differnet.	different.
differnet 	different 
Differnet 	Different 
differnt-	different-
differnt:	different:
differnt;	different;
differnt.	different.
differnt 	different 
Differnt 	Different 
dispirsed-	dispersed-
dispirsed:	dispersed:
dispirsed;	dispersed;
dispirsed.	dispersed.
dispirsed 	dispersed 
Dispirsed 	Dispersed 
distinugish-	distinguish-
distinugish:	distinguish:
distinugish;	distinguish;
distinugish.	distinguish.
distinugish 	distinguish 
Distinugish 	Distinguish 
disucssion-	discussion-
disucssion:	discussion:
disucssion;	discussion;
disucssion.	discussion.
disucssion 	discussion 
Disucssion 	Discussion 
disucssions-	discussions-
disucssions:	discussions:
disucssions;	discussions;
disucssions.	discussions.
disucssions 	discussions 
Disucssions 	Discussions 
disucussed-	discussed-
disucussed:	discussed:
disucussed;	discussed;
disucussed.	discussed.
disucussed 	discussed 
Disucussed 	Discussed 
dobule-	double-
dobule:	double:
dobule;	double;
dobule.	double.
dobule 	double 
Dobule 	Double 
doens't-	doesn't-
doens't:	doesn't:
doens't;	doesn't;
doens't.	doesn't.
doens't 	doesn't 
Doens't 	Doesn't 
dooing-	dooing-
dooing:	dooing:
dooing;	dooing;
dooing.	dooing.
dooing 	dooing 
Dooing 	Dooing 
doubel-	double-
doubel:	double:
doubel;	double;
doubel.	double.
doubel 	double 
Doubel 	Double 
effciency-	efficiency-
effciency:	efficiency:
effciency;	efficiency;
effciency.	efficiency.
effciency 	efficiency 
Effciency 	Efficiency 
effectivly-	effectively-
effectivly:	effectively:
effectivly;	effectively;
effectivly.	effectively.
effectivly 	effectively 
Effectivly 	Effectively 
ellegant-	elegant-
ellegant:	elegant:
ellegant;	elegant;
ellegant.	elegant.
ellegant 	elegant 
Ellegant 	Elegant 
envrionment-	environment-
envrionment:	environment:
envrionment;	environment;
envrionment.	environment.
envrionment 	environment 
Envrionment 	Environment 
evalution-	evaluation-
evalution:	evaluation:
evalution;	evaluation;
evalution.	evaluation.
evalution 	evaluation 
Evalution 	Evaluation 
evalutions-	evaluations-
evalutions:	evaluations:
evalutions;	evaluations;
evalutions.	evaluations.
evalutions 	evaluations 
Evalutions 	Evaluations 
everthing-	everything-
everthing:	everything:
everthing;	everything;
everthing.	everything.
everthing 	everything 
Everthing 	Everything 
everythign-	everything-
everythign:	everything:
everythign;	everything;
everythign.	everything.
everythign 	everything 
Everythign 	Everything 
exmaple-	example-
exmaple:	example:
exmaple;	example;
exmaple.	example.
exmaple 	example 
Exmaple 	Example 
exmaples-	examples-
exmaples:	examples:
exmaples;	examples;
exmaples.	examples.
exmaples 	examples 
Exmaples 	Examples 
expecation-	expectation-
expecation:	expectation:
expecation;	expectation;
expecation.	expectation.
expecation 	expectation 
Expecation 	Expectation 
expectatoin-	expectation-
expectatoin:	expectation:
expectatoin;	expectation;
expectatoin.	expectation.
expectatoin 	expectation 
Expectatoin 	Expectation 
explaination-	explanation-
explaination:	explanation:
explaination;	explanation;
explaination.	explanation.
explaination 	explanation 
Explaination 	Explanation 
explict-	explicit-
explict:	explicit:
explict;	explicit;
explict.	explicit.
explict 	explicit 
Explict 	Explicit 
fakse-	fake-
fakse:	fake:
fakse;	fake;
fakse.	fake.
fakse 	fake 
Fakse 	Fake 
fallign-	falling-
fallign:	falling:
fallign;	falling;
fallign.	falling.
fallign 	falling 
Fallign 	Falling 
fiel-	file-
fiel:	file:
fiel;	file;
fiel.	file.
fiel 	file 
Fiel 	File 
fiels-	files-
fiels:	files:
fiels;	files;
fiels.	files.
fiels 	files 
Fiels 	Files 
firday-	friday-
firday:	friday:
firday;	friday;
firday.	friday.
firday 	friday 
Firday 	Friday 
fodler-	folder-
fodler:	folder:
fodler;	folder;
fodler.	folder.
fodler 	folder 
Fodler 	Folder 
frotn-	front-
frotn:	front:
frotn;	front;
frotn.	front.
frotn 	front 
Frotn 	Front 
gam-	game-
gam:	game:
gam;	game;
gam.	game.
gam 	game 
Gam 	Game 
generatin-	generating-
generatin:	generating:
generatin;	generating;
generatin.	generating.
generatin 	generating 
Generatin 	Generating 
goin-	going-
goin:	going:
goin;	going;
goin.	going.
goin 	going 
Goin 	Going 
haev-	have-
haev:	have:
haev;	have;
haev.	have.
haev 	have 
Haev 	Have 
heirarchies-	hierarchies-
heirarchies:	hierarchies:
heirarchies;	hierarchies;
heirarchies.	hierarchies.
heirarchies 	hierarchies 
Heirarchies 	Hierarchies 
hierachy-	hierarchy-
hierachy:	hierarchy:
hierachy;	hierarchy;
hierachy.	hierarchy.
hierachy 	hierarchy 
Hierachy 	Hierarchy 
hte-	the-
hte:	the:
hte;	the;
hte.	the.
hte 	the 
Hte 	The 
htem-	them-
htem:	them:
htem;	them;
htem.	them.
htem 	them 
Htem 	Them 
idential-	identical-
idential:	identical:
idential;	identical;
idential.	identical.
idential 	identical 
Idential 	Identical 
ign-	ing-
ign:	ing:
ign;	ing;
ign.	ing.
ign 	ing 
Ign 	Ing 
importent-	important-
importent:	important:
importent;	important;
importent.	important.
importent 	important 
Importent 	Important 
incedent-	incident-
incedent:	incident:
incedent;	incident;
incedent.	incident.
incedent 	incident 
Incedent 	Incident 
incedents-	incidents-
incedents:	incidents:
incedents;	incidents;
incedents.	incidents.
incedents 	incidents 
Incedents 	Incidents 
inconvience-	inconvenience-
inconvience:	inconvenience:
inconvience;	inconvenience;
inconvience.	inconvenience.
inconvience 	inconvenience 
Inconvience 	Inconvenience 
increament-	increment-
increament:	increment:
increament;	increment;
increament.	increment.
increament 	increment 
Increament 	Increment 
inidividual-	individual-
inidividual:	individual:
inidividual;	individual;
inidividual.	individual.
inidividual 	individual 
Inidividual 	Individual 
internvals-	intervals-
internvals:	intervals:
internvals;	intervals;
internvals.	intervals.
internvals 	intervals 
Internvals 	Intervals 
karam-	karma-
karam:	karma:
karam;	karma;
karam.	karma.
karam 	karma 
Karam 	Karma 
langauge-	language-
langauge:	language:
langauge;	language;
langauge.	language.
langauge 	language 
Langauge 	Language 
liek-	like-
liek:	like:
liek;	like;
liek.	like.
liek 	like 
Liek 	Like 
lookign-	looking-
lookign:	looking:
lookign;	looking;
lookign.	looking.
lookign 	looking 
Lookign 	Looking 
lvoe-	love-
lvoe:	love:
lvoe;	love;
lvoe.	love.
lvoe 	love 
Lvoe 	Love 
maanagement-	management-
maanagement:	management:
maanagement;	management;
maanagement.	management.
maanagement 	management 
Maanagement 	Management 
maintainance-	maintenance-
maintainance:	maintenance:
maintainance;	maintenance;
maintainance.	maintenance.
maintainance 	maintenance 
Maintainance 	Maintenance 
makign-	making-
makign:	making:
makign;	making;
makign.	making.
makign 	making 
Makign 	Making 
managar-	manager-
managar:	manager:
managar;	manager;
managar.	manager.
managar 	manager 
Managar 	Manager 
mathamatical-	mathematical-
mathamatical:	mathematical:
mathamatical;	mathematical;
mathamatical.	mathematical.
mathamatical 	mathematical 
Mathamatical 	Mathematical 
measureable-	measurable-
measureable:	measurable:
measureable;	measurable;
measureable.	measurable.
measureable 	measurable 
Measureable 	Measurable 
meeitng-	meeting-
meeitng:	meeting:
meeitng;	meeting;
meeitng.	meeting.
meeitng 	meeting 
Meeitng 	Meeting 
meetign-	meeting-
meetign:	meeting:
meetign;	meeting;
meetign.	meeting.
meetign 	meeting 
Meetign 	Meeting 
meetigns-	meetings-
meetigns:	meetings:
meetigns;	meetings;
meetigns.	meetings.
meetigns 	meetings 
Meetigns 	Meetings 
memebr-	member-
memebr:	member:
memebr;	member;
memebr.	member.
memebr 	member 
Memebr 	Member 
memebrs-	members-
memebrs:	members:
memebrs;	members;
memebrs.	members.
memebrs 	members 
Memebrs 	Members 
methodoligy-	methodology-
methodoligy:	methodology:
methodoligy;	methodology;
methodoligy.	methodology.
methodoligy 	methodology 
Methodoligy 	Methodology 
mitgate-	mitigate-
mitgate:	mitigate:
mitgate;	mitigate;
mitgate.	mitigate.
mitgate 	mitigate 
Mitgate 	Mitigate 
motiveated-	motivated-
motiveated:	motivated:
motiveated;	motivated;
motiveated.	motivated.
motiveated 	motivated 
Motiveated 	Motivated 
movign-	moving-
movign:	moving:
movign;	moving;
movign.	moving.
movign 	moving 
Movign 	Moving 
offical-	official-
offical:	official:
offical;	official;
offical.	official.
offical 	official 
Offical 	Official 
ommitted-	omitted-
ommitted:	omitted:
ommitted;	omitted;
ommitted.	omitted.
ommitted 	omitted 
Ommitted 	Omitted 
ommitting-	omitting-
ommitting:	omitting:
ommitting;	omitting;
ommitting.	omitting.
ommitting 	omitting 
Ommitting 	Omitting 
optoins-	options-
optoins:	options:
optoins;	options;
optoins.	options.
optoins 	options 
Optoins 	Options 
otehr-	other-
otehr:	other:
otehr;	other;
otehr.	other.
otehr 	other 
Otehr 	Other 
otehrwise-	otherwise-
otehrwise:	otherwise:
otehrwise;	otherwise;
otehrwise.	otherwise.
otehrwise 	otherwise 
Otehrwise 	Otherwise 
otpions-	options-
otpions:	options:
otpions;	options;
otpions.	options.
otpions 	options 
Otpions 	Options 
otpoins-	options-
otpoins:	options:
otpoins;	options;
otpoins.	options.
otpoins 	options 
Otpoins 	Options 
ownenership-	ownership-
ownenership:	ownership:
ownenership;	ownership;
ownenership.	ownership.
ownenership 	ownership 
Ownenership 	Ownership 
packge-	package-
packge:	package:
packge;	package;
packge.	package.
packge 	package 
Packge 	Package 
palce-	place-
palce:	place:
palce;	place;
palce.	place.
palce 	place 
Palce 	Place 
palces-	places-
palces:	places:
palces;	places;
palces.	places.
palces 	places 
Palces 	Places 
pelase-	please-
pelase:	please:
pelase;	please;
pelase.	please.
pelase 	please 
Pelase 	Please 
performa-	performs-
performa:	performs:
performa;	performs;
performa.	performs.
performa 	performs 
Performa 	Performs 
perminant-	permanent-
perminant:	permanent:
perminant;	permanent;
perminant.	permanent.
perminant 	permanent 
Perminant 	Permanent 
pleae-	please-
pleae:	please:
pleae;	please;
pleae.	please.
pleae 	please 
Pleae 	Please 
pleaes-	please-
pleaes:	please:
pleaes;	please;
pleaes.	please.
pleaes 	please 
Pleaes 	Please 
poeple-	people-
poeple:	people:
poeple;	people;
poeple.	people.
poeple 	people 
Poeple 	People 
prematurly-	prematurely-
prematurly:	prematurely:
prematurly;	prematurely;
prematurly.	prematurely.
prematurly 	prematurely 
Prematurly 	Prematurely 
prioirty-	priority-
prioirty:	priority:
prioirty;	priority;
prioirty.	priority.
prioirty 	priority 
Prioirty 	Priority 
pritnln-	println-
pritnln:	println:
pritnln;	println;
pritnln.	println.
pritnln 	println 
Pritnln 	Println 
proccessor-	processor-
proccessor:	processor:
proccessor;	processor;
proccessor.	processor.
proccessor 	processor 
Proccessor 	Processor 
proejct-	project-
proejct:	project:
proejct;	project;
proejct.	project.
proejct 	project 
Proejct 	Project 
protocal-	protocol-
protocal:	protocol:
protocal;	protocol;
protocal.	protocol.
protocal 	protocol 
Protocal 	Protocol 
prusue-	pursue-
prusue:	pursue:
prusue;	pursue;
prusue.	pursue.
prusue 	pursue 
Prusue 	Pursue 
prusues-	pursues-
prusues:	pursues:
prusues;	pursues;
prusues.	pursues.
prusues 	pursues 
Prusues 	Pursues 
pubilc-	public-
pubilc:	public:
pubilc;	public;
pubilc.	public.
pubilc 	public 
Pubilc 	Public 
purpus-	purpose-
purpus:	purpose:
purpus;	purpose;
purpus.	purpose.
purpus 	purpose 
Purpus 	Purpose 
pythong-	python-
pythong:	python:
pythong;	python;
pythong.	python.
pythong 	python 
Pythong 	Python 
quesiton-	question-
quesiton:	question:
quesiton;	question;
quesiton.	question.
quesiton 	question 
Quesiton 	Question 
quesitons-	questions-
quesitons:	questions:
quesitons;	questions;
quesitons.	questions.
quesitons 	questions 
Quesitons 	Questions 
questoin-	question-
questoin:	question:
questoin;	question;
questoin.	question.
questoin 	question 
Questoin 	Question 
questoins-	questions-
questoins:	questions:
questoins;	questions;
questoins.	questions.
questoins 	questions 
Questoins 	Questions 
reccomend-	recommend-
reccomend:	recommend:
reccomend;	recommend;
reccomend.	recommend.
reccomend 	recommend 
Reccomend 	Recommend 
reccomendation-	recommendation-
reccomendation:	recommendation:
reccomendation;	recommendation;
reccomendation.	recommendation.
reccomendation 	recommendation 
Reccomendation 	Recommendation 
reccomendation-	recommendation-
reccomendation:	recommendation:
reccomendation;	recommendation;
reccomendation.	recommendation.
reccomendation 	recommendation 
Reccomendation 	Recommendation 
reccomended-	recommend-
reccomended:	recommend:
reccomended;	recommend;
reccomended.	recommend.
reccomended 	recommend 
Reccomended 	Recommend 
reccommend-	recommend-
reccommend:	recommend:
reccommend;	recommend;
reccommend.	recommend.
reccommend 	recommend 
Reccommend 	Recommend 
recrutiing-	recruiting-
recrutiing:	recruiting:
recrutiing;	recruiting;
recrutiing.	recruiting.
recrutiing 	recruiting 
Recrutiing 	Recruiting 
recrutiting-	recruiting-
recrutiting:	recruiting:
recrutiting;	recruiting;
recrutiting.	recruiting.
recrutiting 	recruiting 
Recrutiting 	Recruiting 
recuriting-	recruiting-
recuriting:	recruiting:
recuriting;	recruiting;
recuriting.	recruiting.
recuriting 	recruiting 
Recuriting 	Recruiting 
recusion-	recursion-
recusion:	recursion:
recusion;	recursion;
recusion.	recursion.
recusion 	recursion 
Recusion 	Recursion 
regarless-	regardless-
regarless:	regardless:
regarless;	regardless;
regarless.	regardless.
regarless 	regardless 
Regarless 	Regardless 
removs-	removes-
removs:	removes:
removs;	removes;
removs.	removes.
removs 	removes 
Removs 	Removes 
remvoe-	remove-
remvoe:	remove:
remvoe;	remove;
remvoe.	remove.
remvoe 	remove 
Remvoe 	Remove 
reponse-	response-
reponse:	response:
reponse;	response;
reponse.	response.
reponse 	response 
Reponse 	Response 
requriement-	requirement-
requriement:	requirement:
requriement;	requirement;
requriement.	requirement.
requriement 	requirement 
Requriement 	Requirement 
resovle-	resolve-
resovle:	resolve:
resovle;	resolve;
resovle.	resolve.
resovle 	resolve 
Resovle 	Resolve 
roels-	roles-
roels:	roles:
roels;	roles;
roels.	roles.
roels 	roles 
Roels 	Roles 
roght-	right-
roght:	right:
roght;	right;
roght.	right.
roght 	right 
Roght 	Right 
saem-	same-
saem:	same:
saem;	same;
saem.	same.
saem 	same 
Saem 	Same 
saerching-	searching-
saerching:	searching:
saerching;	searching;
saerching.	searching.
saerching 	searching 
Saerching 	Searching 
satisfactoin-	satisfaction-
satisfactoin:	satisfaction:
satisfactoin;	satisfaction;
satisfactoin.	satisfaction.
satisfactoin 	satisfaction 
Satisfactoin 	Satisfaction 
searhc-	search-
searhc:	search:
searhc;	search;
searhc.	search.
searhc 	search 
Searhc 	Search 
seciton-	section-
seciton:	section:
seciton;	section;
seciton.	section.
seciton 	section 
Seciton 	Section 
seperate-	separate-
seperate:	separate:
seperate;	separate;
seperate.	separate.
seperate 	separate 
Seperate 	Separate 
seraching-	searching-
seraching:	searching:
seraching;	searching;
seraching.	searching.
seraching 	searching 
Seraching 	Searching 
serivce-	service-
serivce:	service:
serivce;	service;
serivce.	service.
serivce 	service 
Serivce 	Service 
servcie-	service-
servcie:	service:
servcie;	service;
servcie.	service.
servcie 	service 
Servcie 	Service 
servcies-	services-
servcies:	services:
servcies;	services;
servcies.	services.
servcies 	services 
Servcies 	Services 
shoudl-	should-
shoudl:	should:
shoudl;	should;
shoudl.	should.
shoudl 	should 
Shoudl 	Should 
shuold-	should-
shuold:	should:
shuold;	should;
shuold.	should.
shuold 	should 
Shuold 	Should 
similiar-	similar-
similiar:	similar:
similiar;	similar;
similiar.	similar.
similiar 	similar 
Similiar 	Similar 
skiped-	skipped-
skiped:	skipped:
skiped;	skipped;
skiped.	skipped.
skiped 	skipped 
Skiped 	Skipped 
slience-	silence-
slience:	silence:
slience;	silence;
slience.	silence.
slience 	silence 
Slience 	Silence 
snapshop-	snapshot-
snapshop:	snapshot:
snapshop;	snapshot;
snapshop.	snapshot.
snapshop 	snapshot 
Snapshop 	Snapshot 
soem-	some-
soem:	some:
soem;	some;
soem.	some.
soem 	some 
Soem 	Some 
somethign-	something-
somethign:	something:
somethign;	something;
somethign.	something.
somethign 	something 
Somethign 	Something 
sponser-	sponsor-
sponser:	sponsor:
sponser;	sponsor;
sponser.	sponsor.
sponser 	sponsor 
Sponser 	Sponsor 
spritn-	sprint-
spritn:	sprint:
spritn;	sprint;
spritn.	sprint.
spritn 	sprint 
Spritn 	Sprint 
spritns-	sprints-
spritns:	sprints:
spritns;	sprints;
spritns.	sprints.
spritns 	sprints 
Spritns 	Sprints 
startes-	starts-
startes:	starts:
startes;	starts;
startes.	starts.
startes 	starts 
Startes 	Starts 
stroner-	stronger-
stroner:	stronger:
stroner;	stronger;
stroner.	stronger.
stroner 	stronger 
Stroner 	Stronger 
succient-	succinct-
succient:	succinct:
succient;	succinct;
succient.	succinct.
succient 	succinct 
Succient 	Succinct 
succint-	succinct-
succint:	succinct:
succint;	succinct;
succint.	succinct.
succint 	succinct 
Succint 	Succinct 
succintly-	succinctly-
succintly:	succinctly:
succintly;	succinctly;
succintly.	succinctly.
succintly 	succinctly 
Succintly 	Succinctly 
sugguestion-	suggestion-
sugguestion:	suggestion:
sugguestion;	suggestion;
sugguestion.	suggestion.
sugguestion 	suggestion 
Sugguestion 	Suggestion 
sugguestions-	suggestions-
sugguestions:	suggestions:
sugguestions;	suggestions;
sugguestions.	suggestions.
sugguestions 	suggestions 
Sugguestions 	Suggestions 
sumbitted-	submitted-
sumbitted:	submitted:
sumbitted;	submitted;
sumbitted.	submitted.
sumbitted 	submitted 
Sumbitted 	Submitted 
suporting-	supporting-
suporting:	supporting:
suporting;	supporting;
suporting.	supporting.
suporting 	supporting 
Suporting 	Supporting 
suprise-	surprise-
suprise:	surprise:
suprise;	surprise;
suprise.	surprise.
suprise 	surprise 
Suprise 	Surprise 
surevy-	survey-
surevy:	survey:
surevy;	survey;
surevy.	survey.
surevy 	survey 
Surevy 	Survey 
survye-	survey-
survye:	survey:
survye;	survey;
survye.	survey.
survye 	survey 
Survye 	Survey 
swtich-	switch-
swtich:	switch:
swtich;	switch;
swtich.	switch.
swtich 	switch 
Swtich 	Switch 
taht-	that-
taht:	that:
taht;	that;
taht.	that.
taht 	that 
Taht 	That 
technoligies-	technologies-
technoligies:	technologies:
technoligies;	technologies;
technoligies.	technologies.
technoligies 	technologies 
Technoligies 	Technologies 
teh-	the-
teh:	the:
teh;	the;
teh.	the.
teh 	the 
Teh 	The 
tehere-	there-
tehere:	there:
tehere;	there;
tehere.	there.
tehere 	there 
Tehere 	There 
tehre-	there-
tehre:	there:
tehre;	there;
tehre.	there.
tehre 	there 
Tehre 	There 
thay-	they-
thay:	they:
thay;	they;
thay.	they.
thay 	they 
Thay 	They 
thouhgt-	thought-
thouhgt:	thought:
thouhgt;	thought;
thouhgt.	thought.
thouhgt 	thought 
Thouhgt 	Thought 
thouhgts-	thoughts-
thouhgts:	thoughts:
thouhgts;	thoughts;
thouhgts.	thoughts.
thouhgts 	thoughts 
Thouhgts 	Thoughts 
tomorow-	tomorrow-
tomorow:	tomorrow:
tomorow;	tomorrow;
tomorow.	tomorrow.
tomorow 	tomorrow 
Tomorow 	Tomorrow 
tpye-	type-
tpye:	type:
tpye;	type;
tpye.	type.
tpye 	type 
Tpye 	Type 
trainign-	training-
trainign:	training:
trainign;	training;
trainign.	training.
trainign 	training 
Trainign 	Training 
trainigns-	trainings-
trainigns:	trainings:
trainigns;	trainings;
trainigns.	trainings.
trainigns 	trainings 
Trainigns 	Trainings 
trak-	track-
trak:	track:
trak;	track;
trak.	track.
trak 	track 
Trak 	Track 
transactoin-	transaction-
transactoin:	transaction:
transactoin;	transaction;
transactoin.	transaction.
transactoin 	transaction 
Transactoin 	Transaction 
transactoins-	transactions-
transactoins:	transactions:
transactoins;	transactions;
transactoins.	transactions.
transactoins 	transactions 
Transactoins 	Transactions 
trasparent-	transparent-
trasparent:	transparent:
trasparent;	transparent;
trasparent.	transparent.
trasparent 	transparent 
Trasparent 	Transparent 
ualtrics-	qualtrics-
ualtrics:	qualtrics:
ualtrics;	qualtrics;
ualtrics.	qualtrics.
ualtrics 	qualtrics 
Ualtrics 	Qualtrics 
udpate-	update-
udpate:	update:
udpate;	update;
udpate.	update.
udpate 	update 
Udpate 	Update 
uinque-	unique-
uinque:	unique:
uinque;	unique;
uinque.	unique.
uinque 	unique 
Uinque 	Unique 
unit8-	uint8-
unit8:	uint8:
unit8;	uint8;
unit8.	uint8.
unit8 	uint8 
Unit8 	Uint8 
variabel-	variable-
variabel:	variable:
variabel;	variable;
variabel.	variable.
variabel 	variable 
Variabel 	Variable 
variabels-	variables-
variabels:	variables:
variabels;	variables;
variabels.	variables.
variabels 	variables 
Variabels 	Variables 
varieity-	variety-
varieity:	variety:
varieity;	variety;
varieity.	variety.
varieity 	variety 
Varieity 	Variety 
waht-	what-
waht:	what:
waht;	what;
waht.	what.
waht 	what 
Waht 	What 
wahts-	whats-
wahts:	whats:
wahts;	whats;
wahts.	whats.
wahts 	whats 
Wahts 	Whats 
waitign-	waiting-
waitign:	waiting:
waitign;	waiting;
waitign.	waiting.
waitign 	waiting 
Waitign 	Waiting 
wansts-	wants-
wansts:	wants:
wansts;	wants;
wansts.	wants.
wansts 	wants 
Wansts 	Wants 
wnt-	want-
wnt:	want:
wnt;	want;
wnt.	want.
wnt 	want 
Wnt 	Want 
workign-	working-
workign:	working:
workign;	working;
workign.	working.
workign 	working 
Workign 	Working 
woudl-	would-
woudl:	would:
woudl;	would;
woudl.	would.
woudl 	would 
Woudl 	Would 
yestarday-	yesterday-
yestarday:	yesterday:
yestarday;	yesterday;
yestarday.	yesterday.
yestarday 	yesterday 
Yestarday 	Yesterday 
